R  1920 1080
NO ./textures/eagle.xpm  
SO ./textures/wood.xpm       
WE ./textures/redbrick.xpm    
EA ./textures/greystone 1.xpm     

S ./textures/barrel.xpm     

F 38, 38, 38    
C 128, 128,  122

        1111111111111111111111111
        1000000000110000000000001
        1001000001110000002000001
        1001000000000000000000001
111111111001000000000000000000001
100000000001000001110011111111111
11110011111111011100000000001
11110011111111000000202020201
11000000000000000000020202001
10002000000000000000202020201
1000000000E000000000000000001
11000000000001111111111111111
1111011111000111
   111   11111
